+-+-+-+-+-+-+-+-+-+-+
    |         |     |
+-+ + +-+-+-+ + + + +
|   |     |   | | | |
+ +-+-+-+ + +-+ + +-+
| |   |   | |   |   |
+ + + +-+-+ + +-+-+ +
| | | |       | |   |
+ + + + +-+ +-+ + +-+
|   |   |   | |   | |
+ +-+-+-+ + + +-+-+ +
| |   |   |   |   | |
+ + + + +-+-+-+ + + +
| | | | |     | | | |
+ + +-+ +-+ + + + + +
| |   |     |   | | |
+ +-+ +-+-+-+-+-+ + +
| | | |   |   |   | |
+ + + + +-+ + + + + +
|   |       |   |
+-+-+-+-+-+-+-+-+-+-+
